0 0 1 0 0 2
1 0 1 0 0 2
2 0 1 0 0 2
3 0 1 0 0 2
19 0 1 0 0 7
20 0 1 0 0 7
21 0 1 0 0 7
22 0 1 0 0 7
23 0 1 0 0 7
24 0 1 0 0 7
25 0 1 0 0 7
26 0 1 0 0 7
27 0 1 0 0 7
28 0 1 0 0 7
29 0 1 0 0 7
30 0 1 0 0 2
31 0 2 2 4 2
32 0 3 0 3 2
33 0 2 2 4 2
49 0 0 0 0 7
50 0 1 0 0 7
51 0 0 0 0 7
52 0 0 0 0 7
53 0 0 0 0 7
54 0 0 0 0 7
55 0 1 0 0 7
60 0 1 0 0 2
61 0 0 0 0 2
62 0 2 2 3 2
63 0 0 0 0 2
79 0 0 0 0 7
80 0 0 0 0 7
81 0 0 0 0 7
82 0 1 0 0 7
83 0 0 0 0 7
84 0 0 0 0 7
85 0 0 0 0 7
90 0 1 0 0 2
91 0 1 0 0 2
92 0 2 2 3 2
93 0 3 0 1 2
109 0 1 0 0 7
110 0 0 0 0 7
120 0 1 0 0 7
121 0 0 0 0 7
122 0 0 0 0 7
123 0 0 0 0 7
139 0 0 0 0 7
140 0 0 0 0 7
150 0 1 0 0 7
151 0 0 0 0 7
152 0 1 0 0 7
153 0 0 0 0 7
176 0 1 0 0 7
177 0 1 0 0 7
178 0 1 0 0 7
179 0 1 0 0 7
180 0 1 0 0 7
181 0 0 0 0 7
182 0 0 0 0 7
183 0 0 0 0 7
184 0 1 0 0 7
185 0 0 0 0 7
186 0 0 0 0 7
187 0 0 0 0 7
206 0 1 0 0 7
207 0 1 0 0 7
208 0 1 0 0 7
209 0 1 0 0 7
210 0 1 0 0 7
211 0 1 0 0 7
212 0 0 0 0 7
213 0 0 0 0 7
214 0 0 0 0 7
215 0 0 0 0 7
216 0 0 0 0 7
217 0 0 0 0 7
240 0 1 0 0 7
241 0 0 0 0 7
242 0 0 0 0 7
243 0 1 0 0 7
244 0 0 0 0 7
245 0 0 0 0 7
246 0 1 0 0 7
247 0 0 0 0 7
270 0 1 0 0 7
271 0 0 0 0 7
272 0 0 0 0 7
273 0 0 0 0 7
274 0 0 0 0 7
275 0 0 0 0 7
276 0 0 0 0 7
277 0 0 0 0 7
473 0 0 0 0 7
474 0 0 0 0 7
475 0 0 0 0 7
476 0 1 0 0 7
477 0 0 0 0 7
478 0 0 0 0 7
479 0 1 0 0 7
503 0 0 0 0 7
504 0 0 0 0 7
505 0 0 0 0 7
506 0 0 0 0 7
507 0 0 0 0 7
508 0 0 0 0 7
509 0 1 0 0 7
537 0 0 0 0 7
538 0 1 0 0 7
539 0 1 0 0 7
567 0 0 0 0 7
568 0 0 0 0 7
569 0 1 0 0 7
597 0 0 0 0 7
598 0 0 0 0 7
599 0 1 0 0 7
627 0 0 0 0 7
628 0 0 0 0 7
629 0 1 0 0 7
647 0 1 0 0 7
648 0 1 0 0 7
649 0 1 0 0 7
657 0 0 0 0 7
658 0 0 0 0 7
659 0 1 0 0 7
677 0 0 0 0 7
678 0 0 0 0 7
679 0 0 0 0 7
687 0 1 0 0 7
688 0 0 0 0 7
689 0 1 0 0 7
707 0 0 0 0 7
708 0 0 0 0 7
709 0 0 0 0 7
717 0 0 0 0 7
718 0 0 0 0 7
719 0 1 0 0 7
737 0 1 0 0 7
738 0 0 0 0 7
739 0 0 0 0 7
740 0 0 0 0 7
741 0 0 0 0 7
742 0 0 0 0 7
743 0 0 0 0 7
744 0 0 0 0 7
745 0 0 0 0 7
746 0 0 0 0 7
747 0 0 0 0 7
748 0 0 0 0 7
749 0 1 0 0 7
767 0 1 0 0 7
768 0 1 0 0 7
769 0 0 0 0 7
770 0 0 0 0 7
771 0 1 0 0 7
772 0 0 0 0 7
773 0 0 0 0 7
774 0 0 0 0 7
775 0 0 0 0 7
776 0 0 0 0 7
777 0 0 0 0 7
778 0 1 0 0 7
779 0 1 0 0 7
797 0 0 0 0 7
798 0 1 0 0 7
799 0 1 0 0 7
800 0 1 0 0 7
801 0 1 0 0 7
802 0 1 0 0 7
803 0 0 0 0 7
804 0 0 0 0 7
805 0 1 0 0 7
806 0 1 0 0 7
807 0 1 0 0 7
808 0 1 0 0 7
809 0 1 0 0 7
827 0 0 0 0 7
828 0 1 0 0 7
829 0 1 0 0 7
830 0 1 0 0 7
831 0 1 0 0 7
832 0 1 0 0 7
833 0 1 0 0 7
834 0 1 0 0 7
835 0 1 0 0 7
836 0 1 0 0 7
837 0 1 0 0 7
838 0 1 0 0 7
839 0 1 0 0 7
857 0 0 0 0 7
858 0 0 0 0 7
859 0 1 0 0 7
860 0 1 0 0 7
861 0 1 0 0 7
862 0 1 0 0 7
863 0 1 0 0 7
864 0 1 0 0 7
865 0 1 0 0 7
866 0 1 0 0 7
867 0 1 0 0 7
868 0 1 0 0 7
869 0 1 0 0 7
887 0 0 0 0 7
888 0 0 0 0 7
889 0 0 0 0 7
890 0 1 0 0 7
891 0 1 0 0 7
892 0 1 0 0 7
893 0 1 0 0 7
894 0 1 0 0 7
895 0 1 0 0 7
896 0 1 0 0 7
897 0 1 0 0 7
898 0 1 0 0 7
899 0 1 0 0 7
917 0 0 0 0 7
918 0 0 0 0 7
919 0 0 0 0 7
920 0 0 0 0 7
921 0 0 0 0 7
922 0 1 0 0 7
923 0 1 0 0 7
924 0 0 0 0 7
925 0 1 0 0 7
926 0 0 0 0 7
927 0 1 0 0 7
928 0 1 0 0 7
929 0 1 0 0 7
930 0 1 0 0 2
931 0 1 0 0 2
932 0 1 0 0 2
933 0 1 0 0 2
951 0 0 0 0 7
952 0 0 0 0 7
953 0 0 0 0 7
954 0 0 0 0 7
955 0 0 0 0 7
956 0 1 0 0 6
957 0 1 0 0 6
958 0 1 0 0 6
959 0 1 0 0 6
960 0 1 0 0 2
961 0 2 2 4 2
962 0 2 2 3 2
963 0 2 1 3 2
981 0 0 0 0 7
982 0 0 0 0 7
983 0 0 0 0 7
984 0 0 0 0 7
985 0 0 0 0 7
986 0 1 0 0 6
987 0 0 0 0 6
988 0 6 0 0 6
989 0 1 0 0 6
990 0 1 0 0 2
991 0 3 0 4 2
992 0 3 0 3 2
993 0 1 0 0 2
1011 0 0 0 0 7
1012 0 0 0 0 7
1013 0 0 0 0 7
1014 0 0 0 0 7
1015 0 0 0 0 7
1016 0 0 0 0 6
1017 0 0 0 0 6
1018 0 0 0 0 6
1019 0 1 0 0 6
1020 0 1 0 0 2
1021 0 1 0 0 2
1022 0 1 0 0 2
1023 0 1 0 0 2
1041 0 1 0 0 7
1042 0 1 0 0 7
1043 0 1 0 0 7
1044 0 1 0 0 7
1045 0 1 0 0 7
1046 0 1 0 0 6
1047 0 1 0 0 6
1048 0 1 0 0 6
1049 0 1 0 0 6